00C0B000000C000PB0000
B000P000P00000000C000
0000000B000000B000000
0P0C0000000000000000P
0B00C00B00C000P000000
000000000000000000000
0000B000000000000C000
00P000C0000PB00B000B0
000000000000000000000
000P000B000000PPP0000
0B0C000000C00BP0P0000
0000000P000000PPP0C00
00000000000000000000P
0P00B0000000000P00000
000000000P0B00C000P00
000C00B00000000000000
00000000000P000000B00
C00000000000000P000P0
00P0000P0000C00000000
0000000B0C0000000B000
000B00000000000P0000C
