00C0B000000C0000B0000
B000P000P00000000C000
0000000B000000B000000
0P0C0000000000000000P
0B00C00B00C000P000000
000000000000000000000
0000B000000000000C000
00P000C0000PB00B000B0
000000000000000000000
000P000B000000000P000
0B0C000000C00P0B00000
0000000P0000000000C00
000000000000000000000
0P0000000000000P00000
000000000P0B00C000P00
000C00B00000000000000
00000000000P000000B00
C000000000000000000P0
00P0000P0000C00000000
000000000C0000000B000
000B00000000000P0000C
